##                ###################### ##############  ###############
#A#############                  ####### ##############  ###############
#  ###########   #######################  ##############  ##############
#                  #################                      ##############
#  #######            ######           ################## ##############
#  ################           ########################### ##############
#  ######################################                            ###
#                                 ################################# ####
#  ###################################################    ########## ###
#                                                                ## ####
#####  #####################################################   #### ####
###    ############                                    ####    #### ####
##  ############### ############################      ##    ##   ## ####
#  ##                         ###################### ##  ######   # ####
#  ################## ############################## #  ######   ## ####
#  #############      ##################                ######  ### ####
#  ############# ######                     #################  #### ####
#  ############# ###########################################  ##### ####
###                                                                   B#
########################################################################